3 4 4 4 4 4 4 4 4 4 4 4 4 4 4 4 4 4 4 5
11 12 12 12 12 12 12 12 12 12 12 12 12 12 12 12 12 12 12 13
11 12 12 12 12 12 12 12 12 12 12 12 12 12 12 12 12 12 12 13
11 12 12 12 12 12 12 12 12 12 12 12 12 12 12 12 12 12 12 13
11 12 12 12 12 12 12 12 12 12 12 12 12 12 12 12 12 12 12 13
11 12 12 12 12 12 12 12 12 12 12 12 12 12 12 12 12 12 12 13
11 12 12 12 12 12 12 12 12 12 12 12 12 12 12 12 12 12 12 13
11 12 12 12 12 12 12 12 12 12 12 12 12 12 12 12 12 12 12 13
11 12 12 12 12 12 12 12 12 12 12 12 12 12 12 12 12 12 12 13
11 12 12 12 12 12 12 12 12 12 12 12 12 12 12 12 12 12 12 13
11 12 12 12 12 12 12 12 12 12 12 12 12 12 12 12 12 12 12 13
11 12 12 12 12 12 12 12 12 12 12 12 12 12 12 12 12 12 12 13
11 12 12 12 12 12 12 12 12 12 12 12 12 12 12 12 12 12 12 13
11 12 12 12 12 12 12 12 12 12 12 12 12 12 12 12 12 12 12 13
11 12 12 12 12 12 12 12 12 12 12 12 12 12 12 12 12 12 12 13
11 12 12 12 12 12 12 12 12 12 12 12 12 12 12 12 12 12 12 13
11 12 12 12 12 12 12 12 12 12 12 12 12 12 12 12 12 12 12 13
11 12 12 12 12 12 12 12 12 12 12 12 12 12 12 12 12 12 12 13
11 12 12 12 12 12 12 12 12 12 12 12 12 12 12 12 12 12 12 13
19 20 20 20 20 20 20 20 20 20 20 20 20 20 20 20 20 20 20 21
